.......................................
......................................
......................................
......................................
......................................
.......**********...**********........
.......*................*.............
.......*................*.............
.......*................*.............
.......*................*.............
.......**********.......*.............
.......*................*.............
.......*................*.............
.......*................*.............
.......*............**********........
......................................
......................................
......................................
......................................
......................................
......................................
......................................
......................................
......................................
......................................
......................................